麻黄汤: 麻黄 桂枝 杏仁 甘草 
桂枝汤: 桂枝 芍药 姜 甘草 大枣 热稀粥 温覆 
九味羌活汤: 羌活 防风 苍术 细辛 川芎 白芷 姜 葱白 生地 黄芩 甘草 
小青龙汤: 麻黄 桂枝 姜 细辛 半夏 五味子 芍药 甘草 
止嗽散: 紫菀 百部 白前 桔梗 荆芥 陈皮 甘草 
香薷散: 香薷 厚朴 白扁豆 
银翘散: 银花 连翘 薄荷 牛蒡子 荆芥穗 淡豆豉 竹叶 芦根 桔梗 甘草 
桑菊饮: 桑叶 菊花 杏仁 桔梗 连翘 薄荷 芦根 甘草 
麻杏石甘汤: 麻黄 石膏 杏仁 甘草 
柴葛解肌汤: 柴胡 葛根 羌活 白芷 黄芩 石膏 白芍 甘草 桔梗 姜 大枣 
升麻葛根汤: 升麻 葛根 芍药 甘草 
败毒散: 羌活 独活 川芎 柴胡 桔梗 枳壳 前胡 茯苓 人参 甘草 姜 薄荷 
参苏饮: 苏叶 葛根 前胡 半夏 桔梗 陈皮 枳壳 人参 茯苓 木香 甘草 
再造散: 熟附子 桂枝 细辛 黄芪 人参 羌活 防风 川芎 赤芍 甘草 煨姜 大枣 
加减葳蕤汤: 葳蕤 葱白 淡豆豉 薄荷 桔梗 白薇 甘草 红枣 
大承气汤: 大黄 芒硝 厚朴 枳实 
大陷胸汤: 甘遂 大黄 芒硝 
大黄牡丹汤: 大黄 桃仁 芒硝 牡丹 冬瓜子 
大黄附子汤: 附子 大黄 细辛 
温脾汤: 附子 大黄 芒硝 当归 姜 人参 甘草 
三物备急汤: 巴豆 姜 大黄 
麻子仁丸: 麻子仁 杏仁 芍药 枳实 厚朴 大黄 蜂蜜 
济川煎: 肉苁蓉 当归 牛膝 泽泻 枳壳 升麻 
五仁丸: 杏仁 桃仁 柏子仁 郁李仁 松子仁 陈皮 
十枣汤: 甘遂 大戟 芫花 大枣 
舟车丸: 甘遂 大戟 芫花 黑丑 大黄 青皮 陈皮 槟榔 木香 轻粉 
禹功散: 黑牵牛 茴香 姜汁 
黄龙汤: 大黄 芒硝 厚朴 枳实 人参 当归 桔梗 姜 大枣 甘草 
增液承气汤: 玄参 生地 麦冬 芒硝 大黄 
小柴胡汤: 柴胡 黄芩 半夏 人参 甘草 姜 大枣 
蒿芩清胆汤: 青蒿 黄芩 竹茹 半夏 陈皮 枳壳 赤茯苓 碧玉散 
四逆散: 柴胡 白芍 枳实 甘草 
逍遥散: 柴胡 白芍 当归 白术 茯苓 甘草 薄荷 烧姜 柴胡 
痛泻要方: 白术 白芍 陈皮 防风 
半夏泻心汤: 半夏 姜 黄芩 黄连 人参 大枣 甘草 
大柴胡汤: 柴胡 黄芩 大黄 枳实 芍药 半夏 姜 大枣 
防风通圣散: 防风 荆芥 薄荷 麻黄 大黄 芒硝 石膏 黄芩 桔梗 连翘 当归 白芍 川芎 白术 甘草 姜 
葛根黄芩黄连汤: 葛根 黄芩 黄连 甘草 
疏凿饮子: 商陆 槟榔 大腹皮 茯苓皮 泽泻 木通 椒目 赤小豆 羌活 秦艽 姜 
白虎汤: 生石膏 知母 甘草 粳米 
竹叶石膏汤: 石膏 竹叶 人参 麦冬 半夏 粳米 甘草 
清营汤: 水牛角 生地黄 麦冬 玄参 银花 连翘 竹叶 黄连 丹参 
犀角地黄汤: 水牛角 生地 白芍 丹皮 
黄连解毒汤: 黄连 黄芩 黄柏 栀子 
普济消毒饮: 黄芩 黄连 牛蒡子 连翘 薄荷 僵蚕 玄参 马勃 板蓝根 甘草 桔梗 陈皮 升麻 柴胡 
凉膈散: 连翘 黄芩 山栀 大黄 芒硝 薄荷 竹叶 甘草 白蜜 
仙方活命饮: 金银花 当归 赤芍 乳香 没药 陈皮 白芷 防风 穿山甲 皂角刺 花粉 贝母 甘草 酒 
导赤散: 木通 生地 甘草梢 竹叶 
龙胆泻肝汤: 龙胆草 黄芩 栀子 车前子 木通 泽泻 生地 当归 柴胡 甘草 
左金丸: 黄连 吴茱萸 
泻白散: 桑白皮 地骨皮 粳米 甘草 
苇茎汤: 苇茎 瓜瓣 薏苡仁 桃仁 
清胃散: 黄连 升麻 生地 丹皮 当归 升麻 
玉女煎: 石膏 熟地 黄连 知母 麦冬 牛膝 
芍药汤: 白芍 黄芩 大黄 木香 槟榔 当归 肉桂 甘草 
白头翁汤: 白头翁 黄连 黄柏 秦皮 
六一散: 滑石 甘草 
桂苓甘露饮: 滑石 石膏 寒水石 猪苓 茯苓 泽泻 白术 官桂 甘草 
清暑益气汤: 西洋参 西瓜翠衣 荷梗 石斛 麦冬 黄连 知母 竹叶 甘草 粳米 
青蒿鳖甲汤: 鳖甲 青蒿 生地 知母 丹皮 
清骨散: 银柴胡 知母 胡黄连 地骨皮 秦艽 青蒿 鳖甲 甘草 
当归六黄汤: 当归 生地 熟地 黄芩 黄连 黄柏 黄芪 
理中丸: 姜 人参 白术 甘草 
小建中汤: 饴糖 芍药 桂枝 甘草 姜 大枣 
吴茱萸汤: 吴茱萸 姜 人参 大枣 甘平 
四逆汤: 附子 姜 甘草 
回阳救急汤: 熟附子 姜 肉桂 六君子汤 人参 五味子 麝香 
当归四逆汤: 当归 桂枝 白芍 细辛 通草 甘草 大枣 
黄芪桂枝五物汤: 黄芪 桂枝 芍药 姜 大枣 
阳和汤: 熟地 鹿角胶 肉桂 姜炭 麻黄 白芥子 甘草 
四君子汤: 人参 白术 茯苓 甘草 
参苓白术散: 人参 白术 茯苓 山药 莲子 白扁豆 薏苡仁 砂仁 桔梗 炒甘草 
补中益气汤: 黄芪 人参 甘草 白术 当归 陈皮 升麻 柴胡 甘草 
玉屏风散: 黄芪 白术 防风 
人参蛤蚧散: 蛤蚧 人参 茯苓 杏仁 桑白皮 知母 贝母 甘草 
生脉散: 人参 麦门冬 五味子 
四物汤: 熟地 当归 白芍 川芎 
当归补血汤: 黄芪 当归 
归脾汤: 黄芪 龙眼肉 人参 白术 当归 茯神 酸枣仁 远志 木香 甘草 姜 大枣 
八珍汤: 人参 熟地 白术 茯苓 当归 白芍 川芎 甘草 
泰山磐石散: 人参 黄芪 白术 甘草 当归 熟地 白芍 川芎 续断 砂仁 糯米 
六味地黄丸: 熟地黄 山萸肉 山药 泽泻 牡丹皮 茯苓 
左归丸: 熟地 山萸肉 山药 枸杞子 龟版 鹿角胶 菟丝子 川牛膝 
大补阴丸: 熟地 龟版 黄柏 知母 猪脊髓 蜂蜜 
百合固金汤: 百合 生地 熟地 麦冬 玄参 当归 白芍 贝母 桔梗 甘草 
补肺阿胶汤: 阿胶 马兜铃 牛蒡子 杏仁 糯米 甘草 
一贯煎: 生地黄 北沙参 麦冬 当归 枸杞子 川楝子 
甘草汤: 生地黄 甘草 人参 大枣 阿胶 麦冬 麻仁 桂枝 姜 
益胃汤: 生地 麦冬 北沙参 玉竹 冰糖 
肾气丸: 干地黄 山茱萸 山药 附子 桂枝 泽泻 茯苓 丹皮 
右归丸: 附子 肉桂 鹿角胶 熟地黄 山萸肉 枸杞子 山药 菟丝子 杜仲 当归 
地黄饮子: 熟地黄 山茱萸 肉苁蓉 巴戟天 附子 肉桂 石斛 麦冬 五味子 石菖蒲 远志 茯苓 薄荷 姜 枣 
龟鹿二仙胶: 鹿角胶 龟版 人参 枸杞子 
七宝美髯丹: 何首乌 枸杞子 菟丝子 当归 牛膝 补骨脂 赤茯苓 白茯苓 
牡蛎散: 煅牡蛎 生黄芪 麻黄根 小麦 
九仙散: 罂粟壳 五味子 乌梅 人参 阿胶 款冬花 桑白皮 贝母 桔梗 
真人养脏汤: 罂粟壳 肉豆蔻 诃子 人参 白术 当归 白芍 肉桂 木香 甘草 
四神丸: 补骨脂 肉豆蔻 吴茱萸 五味子 姜 大枣 
桃花汤: 赤石脂 姜 粳米 
金锁固精丸: 沙苑蒺藜 芡实 莲子 龙骨 牡蛎 莲须 
桑螵蛸散: 桑螵蛸 龙骨 龟甲 人参 茯神 菖蒲 远志 当归 
缩泉丸: 益智仁 乌药 山药 
固冲汤: 白术 黄芪 山萸肉 生白芍 煅龙骨 煅牡蛎 棕榈炭 五倍子 海螵蛸 茜草 远志 当归 
固经丸: 龟版 白芍 黄芩 黄柏 椿根皮 香附 
易黄汤: 炒山药 炒芡实 白果 黄柏 车前子 甘草 
朱砂安神丸: 朱砂 黄连 生地 当归 
磁朱丸: 磁石 朱砂 神曲 
天王补心丹: 生地黄 天冬 麦冬 酸枣仁 柏子仁 当归 人参 五味子 茯苓 远志 玄参 丹参 朱砂 桔梗 
酸枣仁汤: 酸枣仁 茯苓 知母 川芎 甘草 
甘麦大枣汤: 小麦 甘草 大枣 
安宫牛黄丸: 牛黄 麝香 水牛角 黄连 黄芩 栀子 冰片 郁金 朱砂 珍珠 雄黄 蜂蜜 金箔 
紫雪: 水牛角 羚羊角 麝香 生石膏 寒水石 滑石 玄参 升麻 木香 丁香 沉香 朱砂 甘草 黄金 
至宝丹: 水牛角 麝香 冰片 安息香 牛黄 玳瑁 朱砂 琥珀 雄黄 金箔 银箔 
苏合香丸: 苏合香 麝香 冰片 安息香 木香 白檀香 沉香 乳香 丁香 香附 白术 诃子肉 荜茇 水牛角 朱砂 
紫金锭: 山慈菇 麝香 千金子霜 红芽大戟 五倍子 雄黄 朱砂 
越鞠丸: 香附 苍术 川芎 神曲 栀子 
暖肝煎: 小茴香 肉桂 乌药 沉香 当归 枸杞子 茯苓 姜 
半夏厚朴汤: 半夏 厚朴 茯苓 姜 苏叶 
厚朴温中汤: 厚朴 草豆蔻 陈皮 木香 姜 姜 茯苓 甘草 
枳实消痞丸: 枳实 厚朴 黄连 半夏 姜 麦芽 人参 白术 白茯苓 甘草 
橘核丸: 橘核 川楝子 桃仁 海藻 昆布 海带 厚朴 枳实 延胡索 木香 肉桂 木通 
四磨汤: 乌药 沉香 槟榔 人参 
天台乌药散: 乌药 小茴香 良姜 木香 青皮 槟榔 川楝子 
柴胡疏肝散: 香附 乌药 延胡索 木香 砂仁 姜 甘草 
良附丸: 高良姜 香附 
金铃子散: 金铃子 玄胡索 
瓜蒌薤白: 瓜蒌实 薤白 白酒 
定喘汤: 麻黄 白果 杏仁 苏子 款冬花 半夏 桑白皮 黄芩 甘草 
苏子降气: 紫苏子 半夏 厚朴 前胡 肉桂 当归 姜 苏叶 大枣 甘草 
旋覆代赭: 旋覆花 代赭石 半夏 姜 人参 大枣 甘草 
橘皮竹茹: 橘皮 竹茹 人参 姜 甘草 大枣 
丁香柿蒂: 丁香 柿蒂 姜 人参 
桃核承气: 桃仁 大黄 桂枝 芒硝 甘草 
血府逐瘀汤: 桃仁 红花 川芎 当归 生地 赤芍 牛膝 柴胡 桔梗 枳壳 生地 甘草 
补阳还五汤: 生黄芪 当归 川芎 赤芍 桃仁 红花 地龙 
复元活血汤: 大黄 柴胡 当归 桃仁 红花 穿山甲 天花粉 甘草 
温经汤: 吴萸 桂枝 当归 川芎 芍药 丹皮 阿胶 麦冬 人参 甘草 半夏 姜 
生化汤: 当归 川芎 炮姜 黄酒 童便 甘草 
桂枝茯苓丸: 桂枝 桃仁 丹皮 芍药 茯苓 白蜜 
失笑散: 五灵脂 蒲黄 酽醋 
丹参饮: 丹参 檀香 砂仁 
鳖甲煎丸: 鳖甲 灶下灰 清酒 赤硝 大黄 虫 蜣螂 鼠妇 蜂窠 桃仁 紫葳 丹皮 人参 阿胶 白芍 
十灰散: 大蓟 小蓟 荷叶 茜草 侧柏叶 白茅根 棕榈炭 栀子 大黄 丹皮 藕汁 萝卜汁 
四生丸: 侧柏叶 生地黄 生荷叶 生艾叶 
咳血方: 青黛 栀子 瓜蒌仁 海粉 诃子 
小蓟饮子: 生地 小蓟 藕节 蒲黄 滑石 竹叶 木通 栀子 当归 甘草 
槐花散: 槐花 侧柏叶 荆芥 枳壳 
黄土汤: 灶心土 白术 附子 生地 阿胶 黄芩 甘草 
大秦艽汤: 秦艽 羌活 白芷 细辛 独活 防风 当归 生地 熟地 川芎 黄芩 石膏 生地 甘草 
消风散: 荆芥 防风 牛蒡子 蝉蜕 苍术 苦参 木通 石膏 知母 生地 胡麻仁 当归 甘草 
川芎茶调散: 川芎 薄荷 荆芥 羌活 白芷 细辛 防风 甘草 
牵正散: 白附子 全蝎 白僵蚕 
小活络丹: 制川乌 制草乌 南星 乳香 没药 地龙 
玉真散: 白附子 天南星 羌活 防风 白芷 天麻 热酒 童便 
独活寄生汤: 独活 防风 秦艽 肉桂 细辛 寄生 牛膝 杜仲 当归 芍药 地黄 川芎 人参 茯苓 甘草 
羚角钩藤汤: 羚角 钩藤 桑叶 菊花 白芍 生地 甘草 竹茹 贝母 茯苓 
镇肝熄风汤: 牛膝 代赭石 龙骨 牡蛎 龟版 白芍 玄参 天冬 茵陈 川楝子 生麦芽 甘草 
天麻钩藤饮: 天麻 钩藤 石决明 川牛膝 栀子 黄芩 益母草 杜仲 桑寄生 夜交藤 朱茯神 
大定风珠: 鸡子黄 阿胶 白芍 地黄 地黄 龟版 鳖甲 麻仁 牡蛎 五味子 甘草 
杏苏散: 杏仁 苏叶 桔梗 枳壳 前胡 半夏 橘皮 茯苓 姜 大枣 
桑杏汤: 桑叶 杏仁 豆豉 贝母 沙参 栀子皮 梨皮 
清燥救肺汤: 桑叶 石膏 麦冬 甘寒 甘草 人参 麻仁 阿胶 杏仁 枇杷叶 
养阴清肺汤: 大生地 玄参 麦冬 白芍 丹皮 贝母 薄荷 甘草 
麦门冬汤: 麦门冬 人参 甘草 粳米 大枣 半夏 
琼玉膏: 生地黄 白蜜 人参 茯苓 
玉液汤: 黄芪 山药 知母 天花粉 鸡内金 葛根 五味子 
增液汤: 玄参 麦冬 生地 
平胃散: 苍术 厚朴 陈皮 甘草 姜 枣 
藿香正气散: 藿香 半夏 厚朴 苏叶 白芷 陈皮 茯苓 白术 大腹皮 桔梗 姜 大枣 甘草 
茵陈蒿汤: 茵陈 栀子 大黄 
三仁汤: 杏仁 白蔻仁 苡仁 半夏 厚朴 通草 滑石 竹叶 
甘露消毒丹: 滑石 茵陈 黄芩 石菖蒲 藿香 白豆蔻 木通 连翘 射干 贝母 薄荷 
连朴饮: 黄连 制厚朴 石菖蒲 半夏 山栀 豆豉 芦根 
八正散: 瞿麦 萹蓄 栀子 木通 大黄 滑石 车前子 甘草 灯心 
二妙散: 黄柏 苍术 
当归拈痛汤: 羌活 茵陈 猪苓 泽泻 黄芩 苦参 防风 升麻 葛根 白术 苍术 人参 当归 知母 甘草 
五苓散: 泽泻 茯苓 猪苓 白术 桂枝 暖水 
猪苓汤: 猪苓 泽泻 茯苓 滑石 阿胶 
防己黄芪汤: 黄芪 防己 白术 姜 大枣 甘草 
五皮散: 茯苓皮 大腹皮 陈皮 姜皮 桑白皮 
苓桂术甘汤: 茯苓 桂枝 白术 甘草 
真武汤: 附子 白术 茯苓 姜 芍药 
甘草姜茯苓白术汤: 姜 茯苓 白术 甘草 
实脾散: 附子 姜 茯苓 白术 木瓜 厚朴 木香 槟榔 草果仁 
萆薢分清饮: 萆薢 石菖蒲 益智仁 乌药 食盐 
完带汤: 白术 山药 人参 苍术 白芍 车前子 陈皮 柴胡 芥穗 甘草 
二陈汤: 半夏 橘红 茯苓 姜 乌梅 甘草 
茯苓丸: 半夏 茯苓 枳壳 朴硝 姜汁 
温胆汤: 半夏 竹茹 枳实 陈皮 茯苓 甘草 姜 枣 
清气化痰丸: 胆南星 瓜蒌仁 黄芩 枳实 陈皮 茯苓 杏仁 半夏 
小陷胸汤: 瓜蒌实 黄连 半夏 
滚痰汤: 青礞石 大黄 黄芩 沉香 
贝母瓜蒌散: 贝母 瓜蒌 天花粉 茯苓 橘红 桔梗 
三子养亲汤: 白芥子 苏子 莱菔子 
苓甘五味姜辛汤: 姜 茯苓 细辛 五味子 甘草 
半夏白术天麻汤: 天麻 半夏 白术 茯苓 橘红 甘草 姜 大枣 
定痫丸: 竹沥 姜汁 胆星 半夏 陈皮 茯苓 甘草 贝母 麦冬 丹参 菖蒲 全蝎 僵蚕 天麻 辰砂 琥珀 远志 灯草 茯神 
保和丸: 山楂 神曲 莱菔子 茯苓 陈皮 半夏 连翘 
枳实导滞丸: 枳实 大黄 黄芩 黄连 白茯苓 白术 泽泻 神曲 
木香槟榔丸: 木香 槟榔 香附 陈皮 青皮 莪术 牵牛 大黄 黄连 黄柏 
枳术丸: 白术 枳实 烧饭 荷叶 
健脾丸: 人参 白术 白茯苓 甘草 木香 砂仁 陈皮 山楂 神曲 麦芽 山药 肉豆蔻 黄连 陈米汤 
失笑丸: 枳实 厚朴 黄连 半夏 姜 四君子 麦芽 
鳖甲煎丸: 鳖甲 灶下灰 清酒 赤硝 大黄 蜣螂 鼠妇 蜂窠 桃仁 紫葳 丹皮 厚朴 人参 阿胶 白芍 
乌梅丸: 乌梅 细辛 蜀椒 桂枝 姜 附子 黄连 黄柏 人参 当归 蜂蜜 
肥儿丸: 神曲 麦芽 使君子 槟榔 黄连 肉豆蔻 木香 猪胆汁 
布袋丸: 使君子 芜荑 人参 白术 白茯苓 甘草 夜明砂 芦荟 猪肉 
化虫丸: 鹤虱 苦楝根 槟榔 枯矾 铅粉 
瓜蒂散: 瓜蒂 赤小豆 豆豉 
救急稀涎散: 皂角 白矾 
盐汤探吐方: 盐汤 食盐 
